Tick,AverageTemperature,WhiteDaisyCount,BlackDaisyCount,TotalDaisyCount,SolarLuminosity
0,8.89,168,168,336,0.8000
1,13.33,158,483,641,0.8000
2,18.93,152,651,803,0.8000
3,23.57,144,684,828,0.8000
4,26.50,134,702,836,0.8000
5,28.51,126,713,839,0.8000
6,29.92,117,720,837,0.8000
7,31.03,116,720,836,0.8000
8,31.62,114,725,839,0.8000
9,32.04,113,725,838,0.8000
10,32.29,110,728,838,0.8000
11,32.55,107,728,835,0.8000
12,32.80,97,741,838,0.8000
13,33.42,88,749,837,0.8000
14,34.14,82,755,837,0.8000
15,34.79,80,760,840,0.8000
16,35.23,73,762,835,0.8000
17,35.74,71,764,835,0.8000
18,36.08,69,768,837,0.8000
19,36.37,59,775,834,0.8000
20,36.95,56,779,835,0.8000
21,37.40,50,782,832,0.8000
22,37.87,51,775,826,0.8000
23,38.00,42,784,826,0.8000
24,38.49,35,790,825,0.8000
25,39.06,35,608,643,0.8000
26,37.60,52,451,503,0.8000
27,34.74,73,493,566,0.8000
28,32.92,96,630,726,0.8000
29,32.46,100,675,775,0.8000
30,32.51,101,701,802,0.8000
31,32.74,101,713,814,0.8000
32,32.97,97,722,819,0.8000
33,33.32,98,720,818,0.8000
34,33.44,98,723,821,0.8000
35,33.53,97,720,817,0.8000
36,33.59,97,719,816,0.8000
37,33.60,97,720,817,0.8000
38,33.62,95,716,811,0.8000
39,33.67,94,716,810,0.8000
40,33.73,95,716,811,0.8000
41,33.72,93,716,809,0.8000
42,33.79,94,713,807,0.8000
43,33.76,88,721,809,0.8000
44,34.05,89,722,811,0.8000
45,34.16,88,726,814,0.8000
46,34.29,89,722,811,0.8000
47,34.29,88,725,813,0.8000
48,34.35,89,719,808,0.8000
49,34.28,90,716,806,0.8000
50,34.19,83,699,782,0.8000
51,34.24,69,675,744,0.8000
52,34.56,52,603,655,0.8000
53,34.67,58,630,688,0.8000
54,34.75,61,671,732,0.8000
55,35.08,62,692,754,0.8000
56,35.40,63,708,771,0.8000
57,35.68,63,729,792,0.8000
58,36.02,60,739,799,0.8000
59,36.40,61,744,805,0.8000
60,36.60,60,749,809,0.8000
61,36.78,60,755,815,0.8000
62,36.93,61,751,812,0.8000
63,36.93,62,743,805,0.8000
64,36.82,62,744,806,0.8000
65,36.77,60,748,808,0.8000
66,36.86,58,747,805,0.8000
67,36.97,59,748,807,0.8000
68,36.99,61,739,800,0.8000
69,36.85,61,741,802,0.8000
70,36.79,60,744,804,0.8000
71,36.83,59,748,807,0.8000
72,36.93,58,747,805,0.8000
73,37.00,57,742,799,0.8000
74,37.03,56,742,798,0.8000
75,37.08,50,717,767,0.8000
76,37.09,44,676,720,0.8000
77,36.93,38,632,670,0.8000
78,36.66,31,611,642,0.8000
79,36.58,28,609,637,0.8000
80,36.63,31,645,676,0.8000
81,36.89,34,663,697,0.8000
82,37.08,36,681,717,0.8000
83,37.27,38,698,736,0.8000
84,37.46,38,726,764,0.8000
85,37.82,38,731,769,0.8000
86,38.04,38,732,770,0.8000
87,38.17,37,734,771,0.8000
88,38.29,37,735,772,0.8000
89,38.35,39,731,770,0.8000
90,38.27,38,741,779,0.8000
91,38.37,38,745,783,0.8000
92,38.45,37,750,787,0.8000
93,38.58,36,752,788,0.8000
94,38.70,36,756,792,0.8000
95,38.80,36,757,793,0.8000
96,38.86,36,759,795,0.8000
97,38.91,35,761,796,0.8000
98,38.99,36,758,794,0.8000
99,38.96,37,755,792,0.8000
100,38.88,38,741,779,0.8000
101,38.67,30,725,755,0.8000
102,38.71,31,687,718,0.8000
103,38.33,30,669,699,0.8000
104,38.01,26,629,655,0.8000
105,37.62,24,636,660,0.8000
106,37.56,23,659,682,0.8000
107,37.79,19,665,684,0.8000
108,38.11,18,686,704,0.8000
109,38.51,19,697,716,0.8000
110,38.78,19,708,727,0.8000
111,39.02,19,726,745,0.8000
112,39.31,20,733,753,0.8000
113,39.48,21,737,758,0.8000
114,39.57,21,740,761,0.8000
115,39.64,22,739,761,0.8000
116,39.63,22,739,761,0.8000
117,39.63,22,736,758,0.8000
118,39.60,22,727,749,0.8000
119,39.50,22,730,752,0.8000
120,39.47,22,729,751,0.8000
121,39.45,22,736,758,0.8000
122,39.51,22,741,763,0.8000
123,39.59,21,747,768,0.8000
124,39.72,20,749,769,0.8000
125,39.84,19,746,765,0.8000
126,39.91,18,722,740,0.8000
127,39.75,15,704,719,0.8000
128,39.62,19,698,717,0.8000
129,39.34,18,679,697,0.8000
130,39.06,17,644,661,0.8000
131,38.62,17,624,641,0.8000
132,38.21,17,596,613,0.8000
133,37.74,16,602,618,0.8000
134,37.60,16,626,642,0.8000
135,37.76,17,642,659,0.8000
136,37.95,17,687,704,0.8000
137,38.48,15,720,735,0.8000
138,39.13,16,746,762,0.8000
139,39.67,15,743,758,0.8000
140,39.95,12,750,762,0.8000
141,40.26,12,755,767,0.8000
142,40.47,13,746,759,0.8000
143,40.45,13,746,759,0.8000
144,40.44,13,744,757,0.8000
145,40.42,13,747,760,0.8000
146,40.43,13,749,762,0.8000
147,40.46,13,759,772,0.8000
148,40.57,13,754,767,0.8000
149,40.58,13,749,762,0.8000
150,40.53,14,736,750,0.8000
151,40.35,13,725,738,0.8000
152,40.19,10,710,720,0.8000
153,40.08,9,706,715,0.8000
154,40.02,12,708,720,0.8000
155,39.90,18,716,734,0.8000
156,39.69,21,725,746,0.8000
157,39.56,22,715,737,0.8000
158,39.36,22,682,704,0.8000
159,38.95,24,662,686,0.8000
160,38.48,23,625,648,0.8000
161,37.92,23,603,626,0.8000
162,37.44,22,588,610,0.8000
163,37.09,22,622,644,0.8000
164,37.24,22,674,696,0.8000
165,37.81,23,716,739,0.8000
166,38.46,22,737,759,0.8000
167,39.02,22,748,770,0.8000
168,39.41,21,763,784,0.8000
169,39.78,21,758,779,0.8000
170,39.92,21,757,778,0.8000
171,39.98,21,757,778,0.8000
172,40.01,21,754,775,0.8000
173,40.00,21,751,772,0.8000
174,39.96,21,750,771,0.8000
175,39.94,20,746,766,0.8000
176,39.92,21,732,753,0.8000
177,39.74,22,729,751,0.8000
178,39.59,22,725,747,0.8000
179,39.47,15,720,735,0.8000
180,39.63,12,716,728,0.8000
181,39.78,12,706,718,0.8000
182,39.76,12,716,728,0.8000
183,39.85,12,710,722,0.8000
184,39.83,10,716,726,0.8000
185,39.96,13,705,718,0.8000
186,39.80,14,700,714,0.8000
187,39.64,14,677,691,0.8000
188,39.34,14,638,652,0.8000
189,38.82,13,619,632,0.8000
190,38.41,13,605,618,0.8000
191,38.07,13,636,649,0.8000
192,38.20,14,673,687,0.8000
193,38.58,14,704,718,0.8000
194,39.07,14,727,741,0.8000
195,39.53,14,755,769,0.8000
196,40.03,14,753,767,0.8000
197,40.26,14,753,767,0.8000
198,40.37,14,756,770,0.8000
199,40.46,14,767,781,0.8000
200,40.61,13,772,785,0.8000
201,40.77,12,757,769,0.8000
202,40.97,9,738,747,0.8050
203,41.22,9,726,735,0.8100
204,41.45,9,694,703,0.8150
205,41.48,9,689,698,0.8200
206,41.67,9,673,682,0.8250
207,41.83,13,670,683,0.8300
208,41.95,17,654,671,0.8350
209,41.92,20,645,665,0.8400
210,41.92,17,628,645,0.8450
211,42.08,17,621,638,0.8500
212,42.31,18,599,617,0.8550
213,42.38,19,581,600,0.8600
214,42.42,29,551,580,0.8650
215,41.98,40,503,543,0.8700
216,41.10,45,455,500,0.8750
217,40.22,50,409,459,0.8800
218,39.35,54,369,423,0.8850
219,38.59,61,333,394,0.8900
220,37.81,71,318,389,0.8950
221,37.10,83,320,403,0.9000
222,36.51,95,320,415,0.9050
223,35.97,111,316,427,0.9100
224,35.25,127,308,435,0.9150
225,34.42,140,296,436,0.9200
226,33.59,155,286,441,0.9250
227,32.72,182,274,456,0.9300
228,31.35,207,261,468,0.9350
229,29.79,229,258,487,0.9400
230,28.35,256,251,507,0.9450
231,26.74,275,248,523,0.9500
232,25.39,294,246,540,0.9550
233,24.17,317,248,565,0.9600
234,22.90,353,244,597,0.9650
235,21.07,390,237,627,0.9700
236,18.88,431,234,665,0.9750
237,16.41,458,237,695,0.9800
238,14.37,483,239,722,0.9850
239,12.62,498,247,745,0.9900
240,11.43,509,249,758,0.9950
241,10.63,519,254,773,1.0000
242,10.08,535,252,787,1.0050
243,9.37,545,250,795,1.0100
244,8.79,551,249,800,1.0150
245,8.45,561,248,809,1.0200
246,8.07,563,253,816,1.0250
247,8.03,556,249,805,1.0300
248,8.40,550,249,799,1.0350
249,8.99,545,261,806,1.0400
250,9.76,540,273,813,1.0450
251,10.62,520,281,801,1.0500
252,12.04,508,293,801,1.0550
253,13.49,504,298,802,1.0600
254,14.58,488,310,798,1.0650
255,16.01,484,317,801,1.0700
256,17.11,472,316,788,1.0750
257,18.27,467,321,788,1.0800
258,19.24,455,326,781,1.0850
259,20.40,442,329,771,1.0900
260,21.65,412,340,752,1.0950
261,23.68,415,344,759,1.1000
262,24.78,419,340,759,1.1050
263,25.30,413,338,751,1.1100
264,25.93,424,330,754,1.1150
265,25.92,437,326,763,1.1200
266,25.55,466,325,791,1.1250
267,24.42,467,330,797,1.1300
268,24.03,467,330,797,1.1350
269,23.99,467,324,791,1.1400
270,24.08,472,317,789,1.1450
271,24.02,488,313,801,1.1500
272,23.51,500,307,807,1.1550
273,22.90,506,299,805,1.1600
274,22.45,523,291,814,1.1650
275,21.67,534,284,818,1.1700
276,20.95,558,264,822,1.1750
277,19.65,581,243,824,1.1800
278,18.10,594,230,824,1.1850
279,16.86,605,210,815,1.1900
280,15.79,619,197,816,1.1950
281,14.75,624,181,805,1.2000
282,14.04,635,173,808,1.2050
283,13.35,650,164,814,1.2100
284,12.50,663,151,814,1.2150
285,11.62,664,134,798,1.2200
286,11.12,670,124,794,1.2250
287,10.70,679,119,798,1.2300
288,10.25,679,113,792,1.2350
289,10.11,686,107,793,1.2400
290,9.87,682,105,787,1.2450
291,10.02,692,102,794,1.2500
292,9.84,713,99,812,1.2550
293,9.08,729,91,820,1.2600
294,8.16,732,89,821,1.2650
295,7.71,722,86,808,1.2700
296,7.98,729,84,813,1.2750
297,7.97,733,84,817,1.2800
298,7.95,737,72,809,1.2850
299,7.82,739,71,810,1.2900
300,7.81,752,71,823,1.2950
301,7.46,749,71,820,1.3000
302,7.53,743,71,814,1.3050
303,7.93,747,66,813,1.3100
304,8.07,731,61,792,1.3150
305,8.83,740,61,801,1.3200
306,9.01,754,55,809,1.3250
307,8.65,766,47,813,1.3300
308,8.08,768,42,810,1.3350
309,7.81,766,40,806,1.3400
310,7.86,767,37,804,1.3450
311,7.95,772,37,809,1.3500
312,7.95,779,34,813,1.3550
313,7.78,781,30,811,1.3600
314,7.72,778,29,807,1.3650
315,7.93,770,27,797,1.3700
316,8.44,782,23,805,1.3750
317,8.34,794,22,816,1.3800
318,7.96,803,21,824,1.3850
319,7.55,800,21,821,1.3900
320,7.59,807,20,827,1.3950
321,7.47,809,17,826,1.4000
322,7.43,816,15,831,1.4050
323,7.26,813,14,827,1.4100
324,7.40,814,12,826,1.4150
325,7.54,815,13,828,1.4200
326,7.71,821,13,834,1.4250
327,7.70,813,13,826,1.4300
328,8.12,817,14,831,1.4350
329,8.31,813,12,825,1.4400
330,8.67,812,10,822,1.4450
331,8.98,803,10,813,1.4500
332,9.61,821,9,830,1.4550
333,9.36,822,9,831,1.4600
334,9.32,817,9,826,1.4650
335,9.61,816,9,825,1.4700
336,9.91,823,9,832,1.4750
337,9.92,822,9,831,1.4800
338,10.09,816,9,825,1.4850
339,10.52,828,9,837,1.4900
340,10.40,821,8,829,1.4950
341,10.72,826,8,834,1.5000
342,10.81,818,7,825,1.5050
343,11.26,831,6,837,1.5100
344,11.11,830,6,836,1.5150
345,11.19,831,6,837,1.5200
346,11.31,831,6,837,1.5250
347,11.49,832,6,838,1.5300
348,11.66,834,5,839,1.5350
349,11.78,832,4,836,1.5400
350,12.02,835,3,838,1.5450
351,12.13,837,2,839,1.5500
352,12.22,839,1,840,1.5550
353,12.30,840,0,840,1.5600
354,12.40,838,0,838,1.5650
355,12.65,837,0,837,1.5700
356,12.92,835,0,835,1.5750
357,13.25,839,0,839,1.5800
358,13.37,839,0,839,1.5850
359,13.55,840,0,840,1.5900
360,13.71,837,0,837,1.5950
361,14.02,836,0,836,1.6000
362,14.32,839,0,839,1.6050
363,14.47,831,0,831,1.6100
364,14.96,840,0,840,1.6150
365,14.98,839,0,839,1.6200
366,15.14,839,0,839,1.6250
367,15.33,835,0,835,1.6300
368,15.68,841,0,841,1.6350
369,15.74,839,0,839,1.6400
370,15.96,841,0,841,1.6450
371,16.10,840,0,840,1.6500
372,16.32,839,0,839,1.6550
373,16.57,840,0,840,1.6600
374,16.77,841,0,841,1.6650
375,16.94,841,0,841,1.6700
376,17.13,841,0,841,1.6750
377,17.34,839,0,839,1.6800
378,17.62,841,0,841,1.6850
379,17.79,839,0,839,1.6900
380,18.06,840,0,840,1.6950
381,18.26,838,0,838,1.7000
382,18.55,840,0,840,1.7050
383,18.72,840,0,840,1.7100
384,18.91,840,0,840,1.7150
385,19.11,841,0,841,1.7200
386,19.28,840,0,840,1.7250
387,19.50,840,0,840,1.7300
388,19.72,837,0,837,1.7350
389,20.04,841,0,841,1.7400
390,20.16,840,0,840,1.7450
391,20.36,839,0,839,1.7500
392,20.60,836,0,836,1.7550
393,20.93,839,0,839,1.7600
394,21.09,839,0,839,1.7650
395,21.27,841,0,841,1.7700
396,21.38,841,0,841,1.7750
397,21.54,839,0,839,1.7800
398,21.80,841,0,841,1.7850
399,21.95,841,0,841,1.7900
400,22.13,841,0,841,1.7950
401,22.32,841,0,841,1.8000
402,22.41,841,0,841,1.8000
403,22.46,841,0,841,1.8000
404,22.48,840,0,840,1.8000
405,22.53,840,0,840,1.8000
406,22.56,837,0,837,1.8000
407,22.68,840,0,840,1.8000
408,22.63,840,0,840,1.8000
409,22.61,840,0,840,1.8000
410,22.59,841,0,841,1.8000
411,22.55,840,0,840,1.8000
412,22.57,839,0,839,1.8000
413,22.61,838,0,838,1.8000
414,22.67,840,0,840,1.8000
415,22.63,841,0,841,1.8000
416,22.57,839,0,839,1.8000
417,22.61,839,0,839,1.8000
418,22.63,839,0,839,1.8000
419,22.65,839,0,839,1.8000
420,22.65,841,0,841,1.8000
421,22.58,841,0,841,1.8000
422,22.54,839,0,839,1.8000
423,22.60,841,0,841,1.8000
424,22.55,841,0,841,1.8000
425,22.53,841,0,841,1.8000
426,22.52,841,0,841,1.8000
427,22.51,841,0,841,1.8000
428,22.51,841,0,841,1.8000
429,22.51,839,0,839,1.8000
430,22.58,839,0,839,1.8000
431,22.62,837,0,837,1.8000
432,22.71,840,0,840,1.8000
433,22.65,840,0,840,1.8000
434,22.62,840,0,840,1.8000
435,22.60,841,0,841,1.8000
436,22.55,839,0,839,1.8000
437,22.61,841,0,841,1.8000
438,22.56,836,0,836,1.8000
439,22.72,841,0,841,1.8000
440,22.61,841,0,841,1.8000
441,22.56,839,0,839,1.8000
442,22.61,839,0,839,1.8000
443,22.63,839,0,839,1.8000
444,22.65,839,0,839,1.8000
445,22.65,841,0,841,1.8000
446,22.58,840,0,840,1.8000
447,22.58,839,0,839,1.8000
448,22.62,840,0,840,1.8000
449,22.60,840,0,840,1.8000
450,22.59,840,0,840,1.8000
451,22.59,840,0,840,1.8000
452,22.58,841,0,841,1.8000
453,22.55,841,0,841,1.8000
454,22.53,840,0,840,1.8000
455,22.55,840,0,840,1.8000
456,22.57,838,0,838,1.8000
457,22.65,840,0,840,1.8000
458,22.62,840,0,840,1.8000
459,22.60,839,0,839,1.8000
460,22.63,841,0,841,1.8000
461,22.57,840,0,840,1.8000
462,22.58,840,0,840,1.8000
463,22.58,838,0,838,1.8000
464,22.66,841,0,841,1.8000
465,22.58,841,0,841,1.8000
466,22.54,840,0,840,1.8000
467,22.56,838,0,838,1.8000
468,22.65,839,0,839,1.8000
469,22.65,839,0,839,1.8000
470,22.65,841,0,841,1.8000
471,22.58,840,0,840,1.8000
472,22.58,839,0,839,1.8000
473,22.62,840,0,840,1.8000
474,22.60,840,0,840,1.8000
475,22.59,840,0,840,1.8000
476,22.59,840,0,840,1.8000
477,22.58,841,0,841,1.8000
478,22.55,841,0,841,1.8000
479,22.53,840,0,840,1.8000
480,22.55,840,0,840,1.8000
481,22.57,838,0,838,1.8000
482,22.65,840,0,840,1.8000
483,22.62,840,0,840,1.8000
484,22.60,840,0,840,1.8000
485,22.59,841,0,841,1.8000
486,22.55,840,0,840,1.8000
487,22.57,840,0,840,1.8000
488,22.57,836,0,836,1.8000
489,22.73,840,0,840,1.8000
490,22.66,841,0,841,1.8000
491,22.58,839,0,839,1.8000
492,22.62,839,0,839,1.8000
493,22.64,839,0,839,1.8000
494,22.65,839,0,839,1.8000
495,22.65,841,0,841,1.8000
496,22.58,840,0,840,1.8000
497,22.58,839,0,839,1.8000
498,22.62,840,0,840,1.8000
499,22.60,840,0,840,1.8000
500,22.59,840,0,840,1.8000
501,22.59,840,0,840,1.8000
502,22.58,841,0,841,1.8000
503,22.55,841,0,841,1.8000
504,22.53,839,0,839,1.8000
505,22.59,840,0,840,1.8000
506,22.59,838,0,838,1.8000
507,22.66,840,0,840,1.8000
508,22.62,840,0,840,1.8000
509,22.60,840,0,840,1.8000
510,22.59,841,0,841,1.8000
511,22.55,840,0,840,1.8000
512,22.57,841,0,841,1.8000
513,22.54,838,0,838,1.8000
514,22.63,841,0,841,1.8000
515,22.57,841,0,841,1.8000
516,22.54,840,0,840,1.8000
517,22.56,839,0,839,1.8000
518,22.61,839,0,839,1.8000
519,22.63,838,0,838,1.8000
520,22.68,841,0,841,1.8000
521,22.60,841,0,841,1.8000
522,22.55,839,0,839,1.8000
523,22.60,841,0,841,1.8000
524,22.56,841,0,841,1.8000
525,22.53,841,0,841,1.8000
526,22.52,841,0,841,1.8000
527,22.51,841,0,841,1.8000
528,22.51,841,0,841,1.8000
529,22.51,840,0,840,1.8000
530,22.55,839,0,839,1.8000
531,22.60,838,0,838,1.8000
532,22.67,840,0,840,1.8000
533,22.62,840,0,840,1.8000
534,22.60,840,0,840,1.8000
535,22.59,841,0,841,1.8000
536,22.55,840,0,840,1.8000
537,22.57,841,0,841,1.8000
538,22.54,837,0,837,1.8000
539,22.67,841,0,841,1.8000
540,22.59,841,0,841,1.8000
541,22.55,839,0,839,1.8000
542,22.60,839,0,839,1.8000
543,22.63,839,0,839,1.8000
544,22.64,838,0,838,1.8000
545,22.69,841,0,841,1.8000
546,22.60,841,0,841,1.8000
547,22.55,839,0,839,1.8000
548,22.60,840,0,840,1.8000
549,22.59,841,0,841,1.8000
550,22.55,841,0,841,1.8000
551,22.53,841,0,841,1.8000
552,22.52,841,0,841,1.8000
553,22.51,841,0,841,1.8000
554,22.51,839,0,839,1.8000
555,22.58,839,0,839,1.8000
556,22.62,838,0,838,1.8000
557,22.68,840,0,840,1.8000
558,22.63,840,0,840,1.8000
559,22.61,840,0,840,1.8000
560,22.59,840,0,840,1.8000
561,22.59,840,0,840,1.8000
562,22.59,840,0,840,1.8000
563,22.58,837,0,837,1.8000
564,22.70,840,0,840,1.8000
565,22.64,841,0,841,1.8000
566,22.57,839,0,839,1.8000
567,22.62,839,0,839,1.8000
568,22.64,839,0,839,1.8000
569,22.65,839,0,839,1.8000
570,22.65,841,0,841,1.8000
571,22.58,840,0,840,1.8000
572,22.58,839,0,839,1.8000
573,22.62,840,0,840,1.8000
574,22.60,840,0,840,1.8000
575,22.59,841,0,841,1.8000
576,22.55,841,0,841,1.8000
577,22.53,841,0,841,1.8000
578,22.52,841,0,841,1.8000
579,22.51,840,0,840,1.8000
580,22.55,840,0,840,1.8000
581,22.56,837,0,837,1.8000
582,22.69,839,0,839,1.8000
583,22.67,840,0,840,1.8000
584,22.63,839,0,839,1.8000
585,22.64,841,0,841,1.8000
586,22.57,840,0,840,1.8000
587,22.58,840,0,840,1.8000
588,22.58,837,0,837,1.8000
589,22.69,841,0,841,1.8000
590,22.60,841,0,841,1.8000
591,22.55,840,0,840,1.8000
592,22.57,839,0,839,1.8000
593,22.61,838,0,838,1.8000
594,22.67,839,0,839,1.8000
595,22.66,841,0,841,1.8000
596,22.59,840,0,840,1.8000
597,22.58,839,0,839,1.8000
598,22.62,840,0,840,1.8000
599,22.60,840,0,840,1.8000
600,22.59,840,0,840,1.8000
601,22.59,840,0,840,1.8000
602,22.53,841,0,841,1.7975
603,22.42,841,0,841,1.7950
604,22.31,840,0,840,1.7925
605,22.25,840,0,840,1.7900
606,22.16,837,0,837,1.7875
607,22.18,840,0,840,1.7850
608,22.03,840,0,840,1.7825
609,21.90,839,0,839,1.7800
610,21.83,841,0,841,1.7775
611,21.66,840,0,840,1.7750
612,21.57,839,0,839,1.7725
613,21.51,836,0,836,1.7700
614,21.54,840,0,840,1.7675
615,21.35,841,0,841,1.7650
616,21.17,839,0,839,1.7625
617,21.11,839,0,839,1.7600
618,21.02,839,0,839,1.7575
619,20.93,839,0,839,1.7550
620,20.83,841,0,841,1.7525
621,20.65,841,0,841,1.7500
622,20.52,839,0,839,1.7475
623,20.47,841,0,841,1.7450
624,20.32,840,0,840,1.7425
625,20.23,841,0,841,1.7400
626,20.10,841,0,841,1.7375
627,19.98,841,0,841,1.7350
628,19.87,841,0,841,1.7325
629,19.76,839,0,839,1.7300
630,19.73,840,0,840,1.7275
631,19.62,837,0,837,1.7250
632,19.63,839,0,839,1.7225
633,19.51,840,0,840,1.7200
634,19.36,839,0,839,1.7175
635,19.27,840,0,840,1.7150
636,19.13,840,0,840,1.7125
637,19.01,840,0,840,1.7100
638,18.90,837,0,837,1.7075
639,18.90,841,0,841,1.7050
640,18.70,841,0,841,1.7025
641,18.55,839,0,839,1.7000
642,18.49,838,0,838,1.6975
643,18.45,838,0,838,1.6950
644,18.37,839,0,839,1.6925
645,18.25,840,0,840,1.6900
646,18.09,840,0,840,1.6875
647,17.96,838,0,838,1.6850
648,17.92,840,0,840,1.6825
649,17.77,840,0,840,1.6800
650,17.64,840,0,840,1.6775
651,17.52,840,0,840,1.6750
652,17.41,841,0,841,1.6725
653,17.26,841,0,841,1.6700
654,17.13,839,0,839,1.6675
655,17.09,837,0,837,1.6650
656,17.09,838,0,838,1.6625
657,16.99,840,0,840,1.6600
658,16.82,840,0,840,1.6575
659,16.68,839,0,839,1.6550
660,16.59,839,0,839,1.6525
661,16.49,840,0,840,1.6500
662,16.35,838,0,838,1.6475
663,16.30,834,0,834,1.6450
664,16.37,841,0,841,1.6425
665,16.09,841,0,841,1.6400
666,15.89,839,0,839,1.6375
667,15.81,837,0,837,1.6350
668,15.79,838,0,838,1.6325
669,15.69,838,0,838,1.6300
670,15.59,839,0,839,1.6275
671,15.44,840,0,840,1.6250
672,15.27,839,0,839,1.6225
673,15.17,841,0,841,1.6200
674,14.99,840,0,840,1.6175
675,14.88,839,0,839,1.6150
676,14.81,841,0,841,1.6125
677,14.64,840,0,840,1.6100
678,14.54,841,0,841,1.6075
679,14.40,838,0,838,1.6050
680,14.38,838,0,838,1.6025
681,14.32,835,0,835,1.6000
682,14.34,839,0,839,1.5975
683,14.15,838,0,838,1.5950
684,14.03,838,0,838,1.5925
685,13.92,838,0,838,1.5900
686,13.80,840,0,840,1.5875
687,13.61,840,0,840,1.5850
688,13.46,834,0,834,1.5825
689,13.55,840,0,840,1.5800
690,13.32,840,0,840,1.5775
691,13.14,837,0,837,1.5750
692,13.11,836,0,836,1.5725
693,13.07,838,0,838,1.5700
694,12.92,835,0,835,1.5675
695,12.90,839,0,839,1.5650
696,12.69,840,0,840,1.5625
697,12.48,836,0,836,1.5600
698,12.47,838,0,838,1.5575
699,12.34,836,0,836,1.5550
700,12.28,836,0,836,1.5525
701,12.20,841,0,841,1.5500
702,11.91,838,0,838,1.5475
703,11.82,840,0,840,1.5450
704,11.64,836,0,836,1.5425
705,11.65,834,0,834,1.5400
706,11.67,829,0,829,1.5375
707,11.80,830,0,830,1.5350
708,11.78,838,0,838,1.5325
709,11.40,839,0,839,1.5300
710,11.12,835,0,835,1.5275
711,11.07,838,0,838,1.5250
712,10.87,834,0,834,1.5225
713,10.87,829,0,829,1.5200
714,10.99,837,0,837,1.5175
715,10.69,831,0,831,1.5150
716,10.71,833,0,833,1.5125
717,10.58,832,0,832,1.5100
718,10.50,835,0,835,1.5075
719,10.28,834,0,834,1.5050
720,10.15,837,0,837,1.5025
721,9.92,833,0,833,1.5000
722,9.89,835,0,835,1.4975
723,9.74,835,0,835,1.4950
724,9.60,835,0,835,1.4925
725,9.48,835,0,835,1.4900
726,9.35,835,0,835,1.4875
727,9.23,832,0,832,1.4850
728,9.22,835,0,835,1.4825
729,9.04,830,0,830,1.4800
730,9.08,824,0,824,1.4775
731,9.26,825,0,825,1.4750
732,9.25,825,0,825,1.4725
733,9.19,832,0,832,1.4700
734,8.83,833,0,833,1.4675
735,8.56,823,0,823,1.4650
736,8.73,825,0,825,1.4625
737,8.68,825,0,825,1.4600
738,8.60,819,0,819,1.4575
739,8.72,832,0,832,1.4550
740,8.23,827,0,827,1.4525
741,8.11,826,0,826,1.4500
742,8.02,827,0,827,1.4475
743,7.88,831,0,831,1.4450
744,7.60,830,0,830,1.4425
745,7.43,823,0,823,1.4400
746,7.55,834,0,834,1.4375
747,7.13,824,0,824,1.4350
748,7.24,829,0,829,1.4325
749,7.04,828,0,828,1.4300
750,6.91,827,0,827,1.4275
751,6.82,828,0,828,1.4250
752,6.68,825,0,825,1.4225
753,6.66,823,0,823,1.4200
754,6.66,820,0,820,1.4175
755,6.71,821,0,821,1.4150
756,6.63,809,0,809,1.4125
757,6.98,803,0,803,1.4100
758,7.31,822,0,822,1.4075
759,6.70,817,0,817,1.4050
760,6.52,796,0,796,1.4025
761,7.15,821,0,821,1.4000
762,6.47,818,0,818,1.3975
763,6.17,808,0,808,1.3950
764,6.34,818,0,818,1.3925
765,5.98,810,0,810,1.3900
766,6.03,796,0,796,1.3875
767,6.52,810,0,810,1.3850
768,6.18,820,0,820,1.3825
769,5.56,824,0,824,1.3800
770,5.04,818,0,818,1.3775
771,4.94,824,0,824,1.3750
772,4.60,810,0,810,1.3725
773,4.89,818,0,818,1.3700
774,4.67,809,0,809,1.3675
775,4.83,818,0,818,1.3650
776,4.50,813,0,813,1.3625
777,4.46,818,0,818,1.3600
778,4.19,818,0,818,1.3575
779,3.99,797,0,797,1.3550
780,4.61,793,0,793,1.3525
781,5.00,806,0,806,1.3500
782,4.64,792,0,792,1.3475
783,4.92,798,0,798,1.3450
784,4.77,816,0,816,1.3425
785,3.95,783,0,783,1.3400
786,4.71,780,0,780,1.3375
787,5.14,796,0,796,1.3350
788,4.68,788,0,788,1.3325
789,4.69,796,0,796,1.3300
790,4.32,797,0,797,1.3275
791,4.03,778,0,778,1.3250
792,4.53,766,0,766,1.3225
793,5.17,783,0,783,1.3200
794,4.78,802,0,802,1.3175
795,3.80,802,0,802,1.3150
796,3.25,801,0,801,1.3125
797,2.94,804,0,804,1.3100
798,2.60,803,0,803,1.3075
799,2.40,795,0,795,1.3050
800,2.53,798,0,798,1.3025
801,2.42,807,0,807,1.3000
802,1.95,806,0,806,1.2975
803,1.69,799,0,799,1.2950
804,1.75,793,0,793,1.2925
805,1.93,788,0,788,1.2900
806,2.14,779,0,779,1.2875
807,2.52,758,0,758,1.2850
808,3.42,759,0,759,1.2825
809,3.76,771,0,771,1.2800
810,3.41,782,0,782,1.2775
811,2.76,756,0,756,1.2750
812,3.33,738,0,738,1.2725
813,4.22,759,0,759,1.2700
814,3.81,775,0,775,1.2675
815,2.94,774,0,774,1.2650
816,2.46,761,0,761,1.2625
817,2.64,744,0,744,1.2600
818,3.30,731,0,731,1.2575
819,4.04,761,0,761,1.2550
820,3.22,763,0,763,1.2525
821,2.66,774,0,774,1.2500
822,1.89,784,0,784,1.2475
823,1.07,775,0,775,1.2450
824,0.92,780,0,780,1.2425
825,0.58,764,0,764,1.2400
826,0.94,760,0,760,1.2375
827,1.20,765,0,765,1.2350
828,1.07,773,0,773,1.2325
829,0.63,759,0,759,1.2300
830,0.86,756,0,756,1.2275
831,1.01,752,0,752,1.2250
832,1.17,743,0,743,1.2225
833,1.51,741,0,741,1.2200
834,1.68,743,0,743,1.2175
835,1.62,749,0,749,1.2150
836,1.29,753,0,753,1.2125
837,0.90,718,0,718,1.2100
838,1.94,692,0,692,1.2075
839,3.36,688,0,688,1.2050
840,4.15,725,0,725,1.2025
841,3.08,751,0,751,1.2000
842,1.49,757,0,757,1.1975
843,0.40,730,0,730,1.1950
844,0.79,722,0,722,1.1925
845,1.21,721,0,721,1.1900
846,1.38,712,0,712,1.1875
847,1.73,721,0,721,1.1850
848,1.49,741,0,741,1.1825
849,0.54,765,0,765,1.1800
850,-0.90,765,0,765,1.1775
851,-1.70,755,0,755,1.1750
852,-1.73,735,0,735,1.1750
853,-0.99,727,0,727,1.1750
854,-0.33,728,0,728,1.1750
855,-0.03,727,0,727,1.1750
856,0.16,718,0,718,1.1750
857,0.59,712,0,712,1.1750
858,1.03,692,0,692,1.1750
859,2.00,676,0,676,1.1750
860,3.08,679,0,679,1.1750
861,3.51,712,0,712,1.1750
862,2.49,736,0,736,1.1750
863,1.08,741,0,741,1.1750
864,0.19,719,0,719,1.1750
865,0.56,695,0,695,1.1750
866,1.65,694,0,694,1.1750
867,2.23,713,0,713,1.1750
868,1.81,727,0,727,1.1750
869,1.08,730,0,730,1.1750
870,0.60,722,0,722,1.1750
871,0.66,720,0,720,1.1750
872,0.76,707,0,707,1.1750
873,1.30,686,0,686,1.1750
874,2.36,682,0,682,1.1750
875,3.04,704,0,704,1.1750
876,2.55,730,0,730,1.1750
877,1.33,767,0,767,1.1750
878,-0.66,783,0,783,1.1750
879,-2.26,779,0,779,1.1750
880,-2.91,772,0,772,1.1750
881,-2.97,767,0,767,1.1750
882,-2.81,767,0,767,1.1750
883,-2.73,750,0,750,1.1750
884,-2.06,739,0,739,1.1750
885,-1.31,717,0,717,1.1750
886,-0.11,711,0,711,1.1750
887,0.72,680,0,680,1.1750
888,2.29,673,0,673,1.1750
889,3.34,695,0,695,1.1750
890,3.04,720,0,720,1.1750
891,1.95,701,0,701,1.1750
892,2.12,698,0,698,1.1750
893,2.32,699,0,699,1.1750
894,2.38,712,0,712,1.1750
895,1.92,724,0,724,1.1750
896,1.25,730,0,730,1.1750
897,0.68,737,0,737,1.1750
898,0.14,741,0,741,1.1750
899,-0.28,738,0,738,1.1750
900,-0.38,720,0,720,1.1750
901,0.24,692,0,692,1.1750
902,1.60,677,0,677,1.1750
903,2.85,683,0,683,1.1750
904,3.24,713,0,713,1.1750
905,2.32,747,0,747,1.1750
906,0.58,754,0,754,1.1750
907,-0.55,771,0,771,1.1750
908,-1.75,789,0,789,1.1750
909,-3.03,786,0,786,1.1750
910,-3.55,757,0,757,1.1750
911,-2.73,744,0,744,1.1750
912,-1.83,737,0,737,1.1750
913,-1.12,712,0,712,1.1750
914,0.17,674,0,674,1.1750
915,2.24,662,0,662,1.1750
916,3.73,664,0,664,1.1750
917,4.40,667,0,667,1.1750
918,4.62,686,0,686,1.1750
919,4.02,708,0,708,1.1750
920,2.89,708,0,708,1.1750
921,2.33,699,0,699,1.1750
922,2.39,684,0,684,1.1750
923,2.98,681,0,681,1.1750
924,3.38,696,0,696,1.1750
925,3.02,719,0,719,1.1750
926,1.98,740,0,740,1.1750
927,0.68,748,0,748,1.1750
928,-0.28,727,0,727,1.1750
929,0.03,705,0,705,1.1750
930,1.01,700,0,700,1.1750
931,1.69,696,0,696,1.1750
932,2.18,699,0,699,1.1750
933,2.31,728,0,728,1.1750
934,1.29,747,0,747,1.1750
935,0.07,772,0,772,1.1750
936,-1.48,792,0,792,1.1750
937,-3.01,790,0,790,1.1750
938,-3.69,784,0,784,1.1750
939,-3.81,765,0,765,1.1750
940,-3.16,731,0,731,1.1750
941,-1.56,718,0,718,1.1750
942,-0.27,695,0,695,1.1750
943,1.24,674,0,674,1.1750
944,2.78,672,0,672,1.1750
945,3.62,675,0,675,1.1750
946,3.93,700,0,700,1.1750
947,3.15,726,0,726,1.1750
948,1.78,736,0,736,1.1750
949,0.73,724,0,724,1.1750
950,0.65,703,0,703,1.1750
951,1.39,686,0,686,1.1750
952,2.40,715,0,715,1.1750
953,1.82,736,0,736,1.1750
954,0.75,740,0,740,1.1750
955,0.06,733,0,733,1.1750
956,-0.03,719,0,719,1.1750
957,0.46,693,0,693,1.1750
958,1.67,698,0,698,1.1750
959,2.10,717,0,717,1.1750
960,1.59,721,0,721,1.1750
961,1.19,743,0,743,1.1750
962,0.17,769,0,769,1.1750
963,-1.32,786,0,786,1.1750
964,-2.70,795,0,795,1.1750
965,-3.73,793,0,793,1.1750
966,-4.17,775,0,775,1.1750
967,-3.71,755,0,755,1.1750
968,-2.73,736,0,736,1.1750
969,-1.53,715,0,715,1.1750
970,-0.15,695,0,695,1.1750
971,1.30,678,0,678,1.1750
972,2.66,676,0,676,1.1750
973,3.41,679,0,679,1.1750
974,3.68,692,0,692,1.1750
975,3.32,700,0,700,1.1750
976,2.84,694,0,694,1.1750
977,2.83,670,0,670,1.1750
978,3.72,673,0,673,1.1750
979,4.06,688,0,688,1.1750
980,3.66,710,0,710,1.1750
981,2.64,730,0,730,1.1750
982,1.38,747,0,747,1.1750
983,0.11,726,0,726,1.1750
984,0.26,713,0,713,1.1750
985,0.83,703,0,703,1.1750
986,1.48,692,0,692,1.1750
987,2.23,691,0,691,1.1750
988,2.63,709,0,709,1.1750
989,2.16,734,0,734,1.1750
990,0.99,759,0,759,1.1750
991,-0.53,771,0,771,1.1750
992,-1.74,779,0,779,1.1750
993,-2.65,793,0,793,1.1750
994,-3.63,784,0,784,1.1750
995,-3.78,764,0,764,1.1750
996,-3.10,738,0,738,1.1750
997,-1.79,711,0,711,1.1750
998,-0.13,682,0,682,1.1750
999,1.79,670,0,670,1.1750
